Spider-Man	Spider-Man 2	Spider-Man 3
The Matrix	The Matrix Reloaded
The Lord of the Rings: The Fellowship of the Ring	The Lord of the Rings: The Two Towers	The Lord of the Rings: The Return of the King
Back to the Future	Back to the Future Part II	Back to the Future Part III
Lethal Weapon	Lethal Weapon 2	Lethal Weapon 3	Lethal Weapon 4
Die Hard	Die Hard 2	Die Hard with a Vengeance	Live Free or Die Hard	A Good Day to Die Hard
Mad Max	The Road Warrior	Mad Max Beyond Thunderdome
Rocky	Rocky II	Rocky III	Rocky IV	Rocky V	Rocky Balboa
First Blood	Rambo: First Blood Part II	Rambo III	Rambo
The Terminator	Terminator 2	Terminator 3: Rise of the Machines	Terminator Salvation
RoboCop	RoboCop 2	RoboCop 3
X-Men
F/X2
X-Men: The Last Stand	X-Men: Days of Future Past
X-Men Origins: Wolverine	The Wolverine
The Fast and the Furious	2 Fast 2 Furious	The Fast and the Furious: Tokyo Drift	Fast & Furious 6
Fast Five
xXx	xXx: State of the Union
Pitch Black	The Chronicles of Riddick	The Chronicles of Riddick: Dark Fury	Riddick
The Transporter	Transporter 3
Crank	Crank: High Voltage
Alien	Aliens	Alien³	Alien: Resurrection
AVP: Alien vs. Predator	Aliens vs. Predator: Requiem
Predator	Predator 2
Predators
The Evil Dead	Evil Dead II	Army of Darkness
Saw	Saw II	Saw III	Saw IV	Saw V	Saw VI	Saw 3D: The Final Chapter
Species	Species II	Species III
Species: The Awakening
Scream	Scream 2	Scream 3	Scream 4
Final Destination	Final Destination 2	Final Destination 3	The Final Destination	Final Destination 5
Underworld	Underworld: Evolution	Underworld: Rise of the Lycans	Underworld Awakening
Darkman	Darkman II: The Return of Durant	Darkman III: Die Darkman Die
Mission: Impossible - Ghost Protocol
Mission: Impossible II	Mission: Impossible III	Mission: Impossible - Ghost Protocol
Transformers	Transformers: Revenge of the Fallen	Transformers: Dark of the Moon
American Pie	American Pie 2	American Wedding	American Pie Presents: Band Camp	American Pie Presents: The Naked Mile	American Pie Presents: Beta House	American Pie Presents: The Book of Love
Fantastic Four
Hulk	The Incredible Hulk
Superman	Superman II	Superman III	Superman IV: The Quest for Peace
Cruel Intentions	Cruel Intentions 2	Cruel Intentions 3
Wild Things	Wild Things 2	Wild Things: Diamonds in the Rough	Wild Things: Foursome
Urban Legend	Urban Legends: Final Cut	Urban Legends: Bloody Mary
The Punisher	Punisher: War Zone
Batman	Batman Returns	Batman Forever
Batman	Batman Begins	The Dark Knight	The Dark Knight Rises
Hellboy	Hellboy II: The Golden Army
Blade	Blade II	Blade: Trinity
Superman Returns
Elektra
The Crow	The Crow: City of Angels	The Crow: Salvation	The Crow: Wicked Prayer
Men in Black	Men in Black II	Men in Black 3
Resident Evil	Resident Evil: Apocalypse	Resident Evil: Extinction	Resident Evil: Afterlife	Resident Evil: Retribution
From Dusk Till Dawn	From Dusk Till Dawn 2: Texas Blood Money	From Dusk Till Dawn 3: The Hangman's Daughter
Spy Kids	Spy Kids 2: Island of Lost Dreams	Spy Kids 3: Game Over
I Know What You Did Last Summer	I Still Know What You Did Last Summer
Garfield
Iron Man	Iron Man 2
Shrek	Shrek 2	Shrek the Third	Shrek Forever After
Tinker Bell	Tinker Bell and the Lost Treasure	Tinker Bell and the Great Fairy Rescue	Secret of the Wings
If These Walls Could Talk	If These Walls Could Talk 2
Jurassic Park	The Lost World: Jurassic Park	Jurassic Park III	Jurassic World
Raiders of the Lost Ark	Indiana Jones and the Temple of Doom	Indiana Jones and the Last Crusade	Indiana Jones and the Kingdom of the Crystal Skull
Star Wars: Episode I - The Phantom Menace	Star Wars: Episode II - Attack of the Clones	Star Wars: Episode III - Revenge of the Sith
Star Wars: Episode IV - A New Hope	Star Wars: Episode V - The Empire Strikes Back	Star Wars: Episode VI - Return of the Jedi
Austin Powers: The Spy Who Shagged Me
Austin Powers: International Man of Mystery	Austin Powers in Goldmember
Twilight	The Twilight Saga: New Moon	The Twilight Saga: Eclipse	The Twilight Saga: Breaking Dawn - Part 1	The Twilight Saga: Breaking Dawn - Part 2
The Messengers
Messengers 2: The Scarecrow
Kill Bill: Vol. 1	Kill Bill: Vol. 2
Desperado	Once Upon a Time in Mexico
The Mask of Zorro	The Legend of Zorro
Ghostbusters	Ghostbusters II
Toy Story	Toy Story 2	Toy Story 3
The Santa Clause	The Santa Clause 2	The Santa Clause 3: The Escape Clause
Doctor Dolittle	Dr. Dolittle 2	Dr. Dolittle 3	Dr. Dolittle: Tail to the Chief	Dr. Dolittle: Million Dollar Mutts
The Nutty Professor	Nutty Professor II: The Klumps
Beverly Hills Cop	Beverly Hills Cop II	Beverly Hills Cop III
48 Hrs.	Another 48 Hrs.
Father of the Bride	Father of the Bride Part II
Speed	Speed 2: Cruise Control
Scary Movie	Scary Movie 2
Scary Movie 3	Scary Movie 4	Scary Movie 5
The Ring	The Ring Two
The Texas Chainsaw Massacre 2
Leatherface: Texas Chainsaw Massacre III	Texas Chainsaw Massacre: The Next Generation	The Texas Chainsaw Massacre	The Texas Chainsaw Massacre: The Beginning
Meet the Parents	Meet the Fockers	Little Fockers
Shanghai Noon	Shanghai Knights
Anaconda
Anacondas: The Hunt for the Blood Orchid
Anaconda: The Offspring	Anacondas: Trail of Blood
Behind Enemy Lines
Behind Enemy Lines II: Axis of Evil	Behind Enemy Lines: Colombia
The Marine	The Marine 2
Walking Tall
Walking Tall: Lone Justice
Walking Tall
Walking Tall Part II	Final Chapter: Walking Tall
Vacancy	Vacancy 2: The First Cut
Hostel	Hostel: Part II	Hostel: Part III
Charlie's Angels	Charlie's Angels: Full Throttle
Bad Boys	Bad Boys II
Big Momma's House	Big Momma's House 2	Big Mommas: Like Father, Like Son
Open Season	Open Season 2	Open Season 3
The Grudge	The Grudge 2
The Grudge 3
Van Wilder: Party Liaison	Van Wilder 2: The Rise of Taj	Van Wilder: Freshman Year
The Butterfly Effect	The Butterfly Effect 2	The Butterfly Effect 3: Revelations
Harold	Harold
A Very Harold & Kumar 3D Christmas
Hollow Man	Hollow Man II
Starship Troopers	Starship Troopers 2: Hero of the Federation	Starship Troopers 3: Marauder
Ice Age	Ice Age: The Meltdown	Ice Age: Dawn of the Dinosaurs	Ice Age: Continental Drift
Madagascar	Madagascar: Escape 2 Africa	Madagascar 3: Europe's Most Wanted
Kung Fu Panda	Kung Fu Panda 2
Cars	Cars 2
The Lion King	The Lion King 2: Simba's Pride	The Lion King 1 1/2
The Little Mermaid	The Little Mermaid 2: Return to the Sea	The Little Mermaid: Ariel's Beginning
The Prince and Me
The Prince	The Prince	The Prince
The Princess Diaries	The Princess Diaries 2: Royal Engagement
Bridget Jones's Diary	Bridget Jones: The Edge of Reason	Bridget Jones's Baby
Mulan
Bambi	Bambi II
The Bourne Identity	The Bourne Supremacy	The Bourne Ultimatum	The Bourne Legacy
The Fox and the Hound	The Fox and the Hound 2
Brother
Brother Bear	Brother Bear 2
Class of 1999	Class of 1999 II: The Substitute
Green Lantern: First Flight
Green Lantern: Emerald Knights
Clash of the Titans	Wrath of the Titans
Halloween	Halloween II	Halloween III: Season of the Witch	Halloween 4: The Return of Michael Myers	Halloween 5	Halloween: The Curse of Michael Myers	Halloween H20: 20 Years Later	Halloween: Resurrection
Halloween	Halloween II
Halloween
Joy Ride
Joy Ride 2: Dead Ahead
Wrong Turn	Wrong Turn 2: Dead End
Wrong Turn 3: Left for Dead
Wishmaster	Wishmaster 2: Evil Never Dies	Wishmaster 3: Beyond the Gates of Hell	Wishmaster 4: The Prophecy Fulfilled
Hot Shots!	Hot Shots! Part Deux
The Naked Gun: From the Files of Police Squad!	The Naked Gun 2½: The Smell of Fear	Naked Gun 33 1/3: The Final Insult
Marley	Marley
Beverly Hills Chihuahua	Beverly Hills Chihuahua 2
Night at the Museum	Night at the Museum: Battle of the Smithsonian
Beauty and the Beast	Beauty and the Beast: The Enchanted Christmas	Belle's Magical World
Cinderella
Cinderella II: Dreams Come True	A Cinderella Story	Another Cinderella Story	A Cinderella Story: Once Upon a Song
Hellraiser	Hellbound: Hellraiser II	Hellraiser III: Hell on Earth	Hellraiser: Bloodline	Hellraiser: Inferno	Hellraiser: Hellseeker	Hellraiser: Deader	Hellraiser: Hellworld	Hellraiser: Revelations
Hellraiser
Candyman	Candyman: Farewell to the Flesh	Candyman: Day of the Dead
Jeepers Creepers	Jeepers Creepers II	Jeepers Creepers III
Boogeyman
Boogeyman 2	Boogeyman 3
The Boogey Man
The Prophecy	The Prophecy II	The Prophecy 3: The Ascent	The Prophecy: Uprising	The Prophecy: Forsaken
Street Kings	Street Kings 2: Motor City
S.W.A.T.
S.W.A.T.: Firefight
The Omen	Damien: Omen II
The Final Conflict
Omen IV: The Awakening
Step Up	Step Up 2: The Streets	Step Up 3D	Step Up Revolution
Save the Last Dance 2
The Karate Kid	The Karate Kid Part II	The Karate Kid Part III	The Next Karate Kid
The Karate Kid
The Mummy	The Mummy Returns	The Mummy: Tomb of the Dragon Emperor
The Scorpion King	The Scorpion King: Rise of a Warrior
Alvin and the Chipmunks	Alvin and the Chipmunks: The Squeakquel	Alvin and the Chipmunks: Chipwrecked
The Fugitive	U.S. Marshals
Mimic	Mimic 2	Mimic: Sentinel
Analyze This	Analyze That
The Whole Nine Yards	The Whole Ten Yards
The Addams Family	Addams Family Values
Sniper	Sniper 2	Sniper 3	Sniper: Reloaded
Sex and the City	Sex and the City 2
Girls on Top
Wayne's World	Wayne's World 2
The French Connection	French Connection II
The Mask	Son of the Mask
The Pink Panther	The Pink Panther 2
The Silence of the Lambs
Hannibal	Red Dragon
Hannibal Rising
Manhunter
Land of the Dead
A Nightmare on Elm Street	A Nightmare on Elm Street 2: Freddy's Revenge	A Nightmare on Elm Street 3: Dream Warriors	A Nightmare on Elm Street 4: The Dream Master	A Nightmare on Elm Street 5: The Dream Child	Freddy's Dead: The Final Nightmare	New Nightmare
A Nightmare on Elm Street	Freddy vs. Jason
Friday the 13th	Friday the 13th Part 2	Friday the 13th Part III	Friday the 13th: The Final Chapter	Friday the 13th: A New Beginning	Jason Lives: Friday the 13th Part VI	Friday the 13th Part VII: The New Blood	Friday the 13th Part VIII: Jason Takes Manhattan	Jason Goes to Hell: The Final Friday
Friday the 13th
Pirates of the Caribbean: The Curse of the Black Pearl	Pirates of the Caribbean: Dead Man's Chest	Pirates of the Caribbean: At World's End	Pirates of the Caribbean: On Stranger Tides
Lara Croft: Tomb Raider	Lara Croft Tomb Raider: The Cradle of Life
The Godfather	The Godfather: Part II	The Godfather: Part III
Ocean's Eleven	Ocean's Twelve	Ocean's Thirteen
Planet of the Apes
Beneath the Planet of the Apes	Escape from the Planet of the Apes	Conquest of the Planet of the Apes	Battle for the Planet of the Apes
Arthur and the Invisibles
Cheaper by the Dozen	Cheaper by the Dozen 2
Ace Ventura: Pet Detective	Ace Ventura: When Nature Calls
Nanny McPhee	Nanny McPhee Returns
Sharpe's Challenge
The Expendables	The Expendables 2
G.I. Joe: The Rise of Cobra	G.I. Joe: Retaliation
Turbulence	Turbulence 2: Fear of Flying	Turbulence 3: Heavy Metal
Universal Soldier	Universal Soldier: The Return	Universal Soldier: Regeneration	Universal Soldier: Day of Reckoning
Dungeons & Dragons	Dungeons & Dragons	Dungeons & Dragons
The Librarian: Quest for the Spear	The Librarian: Return to King Solomon's Mines
Elizabeth	Elizabeth: The Golden Age
Harry Potter and the Sorcerer's Stone	Harry Potter and the Chamber of Secrets	Harry Potter and the Prisoner of Azkaban	Harry Potter and the Goblet of Fire	Harry Potter and the Order of the Phoenix	Harry Potter and the Half-Blood Prince	Harry Potter and the Deathly Hallows: Part 1	Harry Potter and the Deathly Hallows: Part 2
28 Days Later...	28 Weeks Later
The Da Vinci Code	Angels & Demons
The Boondock Saints	The Boondock Saints II: All Saints Day
Dirty Dancing	Dirty Dancing: Havana Nights
Donnie Darko	S. Darko
Love Comes Softly	Love's Abiding Joy	Love's Unfolding Dream
Ghost Rider	Ghost Rider: Spirit of Vengeance
The Exorcist	Exorcist II: The Heretic	The Exorcist III	Exorcist: The Beginning	Dominion: Prequel to the Exorcist
The Last Exorcism
The X Files	The X Files: I Want to Believe
The Crimson Rivers
Les visiteurs	Les couloirs du temps: Les visiteurs II
Battle Royale	Battle Royale II
Terms of Endearment
The Evening Star
Happy Feet	Happy Feet Two
Romancing the Stone	The Jewel of the Nile	The War of the Roses
Look Who's Talking	Look Who's Talking Too	Look Who's Talking Now
Legally Blonde	Legally Blonde 2: Red, White & Blonde
American Psycho
American Psycho II: All American Girl
Johnny English	Johnny English Reborn
Scooby-Doo	Scooby-Doo 2: Monsters Unleashed
How to Train Your Dragon	How to Train Your Dragon 2
Home Alone	Home Alone 2: Lost in New York	Home Alone 3
Home Alone 4
Balto	Balto: Wolf Quest	Balto III: Wings of Change
Mesrine Part 1: Killer Instinct
The Tall Blond Man with One Black Shoe
Love-Carrot 3
Epoch
Short Circuit	Short Circuit 2
Pet Sematary	Pet Sematary II
The Three Musketeers
The Four Musketeers: Milady's Revenge
The Fly	The Fly II
Rush Hour	Rush Hour 2	Rush Hour 3
Police Academy	Police Academy 2: Their First Assignment	Police Academy 3: Back in Training	Police Academy 4: Citizens on Patrol	Police Academy 5: Assignment: Miami Beach	Police Academy 6: City Under Siege	Police Academy: Mission to Moscow
Paranormal Activity	Paranormal Activity 2	Paranormal Activity 3	Paranormal Activity 4
Dirty Harry	Magnum Force	Sudden Impact	The Dead Pool
The Enforcer
Smokin' Aces	Smokin' Aces 2: Assassins' Ball
Under Siege	Under Siege 2: Dark Territory
Death Race	Death Race 2	Death Race: Inferno
Atlas Shrugged: Part I	Atlas Shrugged II: The Strike
National Treasure	National Treasure: Book of Secrets
The Hangover	The Hangover Part II	The Hangover Part III
Deuce Bigalow: Male Gigolo	Deuce Bigalow: European Gigolo
Fletch	Fletch Lives
City of God
Elite Squad	Elite Squad: The Enemy Within
Kick-Ass	Kick-Ass 2
RED	RED 2
The Talented Mr. Ripley
Ripley's Game
Escape from New York	Escape from L.A.
The Lawnmower Man
Lawnmower Man 2: Beyond Cyberspace
Honey, I Shrunk the Kids	Honey, We Shrunk Ourselves!
Honey	Honey 2
Psycho	Psycho II
Fortress	Fortress 2
White Noise	White Noise 2: The Light
Cocoon	Cocoon: The Return
Magic Mike	Magic Mike XXL
Jumper
Red Riding: The Year of Our Lord 1974	Red Riding: The Year of Our Lord 1980	Red Riding: The Year of Our Lord 1983
Lilo & Stitch	Lilo & Stitch
The Sisterhood of the Traveling Pants	The Sisterhood of the Traveling Pants 2
Bad Santa	Bad Santa 2
District B13	District 13: Ultimatum
Taxi 2	Taxi 3	Taxi 4
Miss Congeniality	Miss Congeniality 2: Armed and Fabulous
Screamers	Screamers: The Hunting
I Am Legend
Sherlock Holmes	Sherlock Holmes: A Game of Shadows
Star Trek: The Motion Picture	Star Trek II: The Wrath of Khan	Star Trek III: The Search for Spock	Star Trek IV: The Voyage Home	Star Trek V: The Final Frontier	Star Trek VI: The Undiscovered Country	Star Trek: Generations	Star Trek: First Contact	Star Trek: Insurrection	Star Trek: Nemesis
Basic Instinct	Basic Instinct 2
Undisputed	Undisputed 2: Last Man Standing	Undisputed 3: Redemption
Resident Evil: Damnation
The Amazing Spider-Man	The Amazing Spider-Man 2
Machete	Machete Kills
21 Jump Street	22 Jump Street
The Arrival
Arrival II
8MM	8MM 2
The Girl with the Dragon Tattoo
The Girl Who Played with Fire	The Girl Who Kicked the Hornet's Nest
Alone in the Dark
Alone in the Dark II
BloodRayne
In the Name of the King: A Dungeon Siege Tale
Cube
Cube²: Hypercube
Cubeº: Cube Zero
Bad Ass	Bad Ass 2: Bad Asses
12 Rounds
12 Rounds 2: Reloaded	The Marine 3: Homefront
Insidious	Insidious: Chapter 2	Insidious: Chapter 3
Monsters	Monsters: Dark Continent
Divergent	Insurgent	Allegiant
Rio	Rio 2
Jarhead	Jarhead 2: Field of Fire
The Best Exotic Marigold Hotel	The Second Best Exotic Marigold Hotel
Nymphomaniac: Vol. I	Nymphomaniac: Vol. II
The Lego Movie
Fast & Furious 6	Furious 7
The Woman in Black	The Woman in Black 2: Angel of Death
The Trip	The Trip to Italy
The Best Man	The Best Man Holiday
Agent Cody Banks	Agent Cody Banks 2: Destination London
101 Dalmatians	102 Dalmatians
Anchorman: The Legend of Ron Burgundy	Anchorman 2: The Legend Continues
Armour of God 2: Operation Condor
Police Story
Supercop	Once a Cop
Police Story: Lockdown
Police Story 4: First Strike
Before Sunrise	Before Sunset	Before Midnight
Asterix and Obelix Meet Cleopatra
Tremors	Tremors II: Aftershocks	Tremors 3: Back to Perfection	Tremors 4: The Legend Begins
Transformers: Age of Extinction	Transformers: The Last Knight
Teenage Mutant Ninja Turtles	Teenage Mutant Ninja Turtles: Out of the Shadows
The Equalizer
The Hunger Games	The Hunger Games: Catching Fire	The Hunger Games: Mockingjay - Part 1	The Hunger Games: Mockingjay - Part 2
The Omega Code	Megiddo: The Omega Code 2
Ride Along	Ride Along 2
The Muppets	Muppets Most Wanted
The Muppet Movie	The Muppets Take Manhattan
The Great Muppet Caper	Muppets from Space
A Haunted House	A Haunted House 2
Think Like a Man	Think Like a Man Too
Into the Blue
Into the Blue 2: The Reef
Critters	Critters 2	Critters 3	Critters 4
Dolphin Tale	Dolphin Tale 2
Hot Tub Time Machine	Hot Tub Time Machine 2
Paul Blart: Mall Cop	Paul Blart: Mall Cop 2
Horrible Bosses	Horrible Bosses 2
The Descent	The Descent: Part 2
Quarantine	Quarantine 2: Terminal
[Rec]	[Rec] 2	[REC] 3: Genesis	[REC] 4: Apocalypse
V/H/S
V/H/S/2	V/H/S Viral
Grave Encounters	Grave Encounters 2
An American Werewolf in London	An American Werewolf in Paris
The Blues Brothers	Blues Brothers 2000
Fantomas
Carlito's Way	Carlito's Way: Rise to Power
The Hunt for Eagle One	The Hunt for Eagle One: Crash Point
The Base	Guilty as Charged
Fright Night
Fright Night Part 2	Fright Night	Fright Night 2
Child's Play	Child's Play 2	Child's Play 3
Bride of Chucky	Seed of Chucky	Curse of Chucky	Cult of Chucky
Get Smart
The Dead	The Dead 2: India
The Cell	The Cell 2
Major League	Major League II	Major League: Back to the Minors
Mirrors	Piranha 3D	Piranha 3DD
The Hills Have Eyes	The Hills Have Eyes II
I Spit on Your Grave	I Spit on Your Grave 2
The Collector	The Collection
The Hills Have Eyes
The Hills Have Eyes Part II
30 Days of Night	30 Days of Night: Dark Days
The Mechanic	Mechanic: Resurrection
Ted	Ted 2
Poltergeist	Poltergeist II: The Other Side	Poltergeist III
The Maze Runner	Maze Runner: The Scorch Trials
Clerks	Clerks II
The Raid: Redemption	The Raid 2
Cat People
The Curse of the Cat People
The Hobbit: An Unexpected Journey	The Hobbit: The Desolation of Smaug	The Hobbit: The Battle of the Five Armies
Hotel Transylvania	Hotel Transylvania 2
Wall Street	Wall Street: Money Never Sleeps
Fistful of Dollars	For a Few Dollars More	The Good, the Bad and the Ugly
Young Guns	Young Guns II
Finding Nemo	Finding Dory
Bad Lieutenant
Bad Lieutenant: Port of Call New Orleans
Taken	Taken 2	Taken 3
Project A	Project A 2
Cloverfield	10 Cloverfield Lane
Olympus Has Fallen	London Has Fallen
My Big Fat Greek Wedding	My Big Fat Greek Wedding 2
Man of Steel	Batman v Superman: Dawn of Justice	Justice League
The Avengers	Avengers: Age of Ultron
Thor	Thor: The Dark World	Thor: Ragnarok
Captain America: The First Avenger	Captain America: The Winter Soldier	Captain America: Civil War
Deadpool
The Conjuring	The Conjuring 2
The Purge	The Purge: Anarchy	The Purge: Election Year
Zoolander	Zoolander 2
Alice in Wonderland	Alice Through the Looking Glass
Independence Day	Independence Day: Resurgence
Unbreakable
Split
Alice Through the Looking Glass
The Hustler
The Color of Money
Blue Crush	Blue Crush 2
Trainspotting	T2 Trainspotting
Blade Runner	Blade Runner 2049
Guardians of the Galaxy	Guardians of the Galaxy Vol. 2
Prometheus	Alien: Covenant
Rise of the Planet of the Apes	Dawn of the Planet of the Apes	War for the Planet of the Apes
Star Trek	Star Trek: Into Darkness	Star Trek: Beyond
Gremlins	Gremlins 2: The New Batch
Dumb and Dumber	Dumb and Dumberer: When Harry Met Lloyd	Dumb and Dumber To
Despicable Me	Despicable Me 2	Despicable Me 3
Kingsman: The Secret Service	Kingsman: The Golden Circle
